𧢮	䚕
吆	䶸
屮	䶹
肭	䶺
䏙	䶻
朡	䶽
𣢧	䶾
飢	䶿
郎	郞
隸	隷
蘒	蘒
凵	𠙴
壷	𡔳
多	𡖇
𡚨	𡚧
徚	𢔅
涅	𣵀
玥	𤣽
𤰶	𤰶
𥄙	𥄚
贛	𥫔
𦖨	𦖝
𦰶	𦴆
䕫	𧃰
𤠔	𪻅
叱	𫜸
卑	𭅡
泍	𭰉
𢛔	𱞫
甾	𱰭
緇	𱹼
