䁘	䁘󠄂
䎗	䎗󠄁
䘕	䘕󠄁
䤾	䤾󠄁
䨩	䨩󠄂
乸	乸󠄁
倩	倩󠄄
凑	凑󠄂
啫	啫󠄁
嚤	嚤󠄁
姸	姸󠄂
岍	岍󠄃
岭	岭󠄂
樋	樋󠄅
汧	汧󠄅
淎	淎󠄂
瀞	瀞󠄉
熮	熮󠄂
熻	熻󠄁
硏	硏󠄄
窰	窰󠄂
綉	綉󠄂
綫	綫󠄂
翬	翬󠄂
翱	翱󠄁
翺	翺󠄃
茺	茺󠄄
菁	菁󠄇
蒨	蒨󠄆
蔴	蔴󠄄
踭	踭󠄁
邨	邨󠄇
銹	銹󠄂
鍮	鍮󠄄
靜	靜󠄉
靭	靭󠄆
飬	飬󠄂
餸	餸󠄁
驣	驣󠄁
黙	黙󠄂
𡩴	𡩴󠄁
𥖄	𥖄󠄁
𦏹	𦏹󠄁
𦐐	𦐐󠄁
𦐹	𦐹󠄁
𦒉	𦒉󠄃
𧝁	𧝁󠄁
𬽺	𬽺󠄁
