廊	廊
朗	朗
虜	虜
晴	晴
猪	猪
礼	礼
神	神
祥	祥
福	福
靖	靖
精	精
羽	羽
諸	諸
都	都
飯	飯
飼	飼
僧	僧
塀	塀
層	層
慨	慨
憎	憎
既	既
旣	既
暑	暑
渚	渚
煮	煮
社	社
祉	祉
祈	祈
祐	祐
祖	祖
祝	祝
禍	禍
禎	禎
穀	穀
節	節
署	署
者	者
著	著
視	視
贈	贈
逸	逸
響	響
