丽	丽
備	備
具	具
㒹	㒹
冗	冗
𩇟	𩇟
剆	剆
北	北
善	善
喳	喳
噴	噴
堲	堲
奢	奢
姬	姬
姘	姘
寘	寘
岍	岍
𡷦	𡷦
嵮	嵮
嵫	嵫
幩	幩
㡢	㡢
庰	庰
廊	廊
𣊸	𣊸
𦇚	𦇚
㣣	㣣
憤	憤
拼	拼
揤	揤
𢯱	𢯱
揅	揅
撝	撝
暑	暑
