𬺽	㐂
𠪨	㕓
𠬍	㕙
䎛	㖈
㦳	㘽
𡎲	㙜
𪦅	㛴
𡤎	㜶
𡬶	㝷
𡭪	㝸
𥚋	㞊
𡉚	㞷
𡶨	㟁
𪩙	㠚
𢎼	㢭
𢳌	㨾
攑	㩮
𢼨	㩻
𢼮	㩻
𢺾	㪆
𢼕	㪆
𣂚	㪿
𣏈	㭃
𣚓	㯞
𣪝	㲄
浻	㴄
𤈎	㶷
𦻐	㷹
𤡙	㺑
𤢷	㺤
𤬳	㼦
蕤	㽔
䃱	䃸
𥬺	䇦
𥮚	䈀
𦢙	䑎
𧆲	䖒
𮓱	䖝
䘂	䘋
𧚎	䙄
龻	䜌
𨡞	䤄
𨣲	䤘
𨨿	䤹
𩣙	䮢
𩰘	䰗
䱎	䱍
𮬹	䳟
𡤞	䶯
𣢧	䶾
丢	丟
𫝄	久
𠂰	乕
𢁺	乕
𠄣	亙
𠓛	亼
𫝆	今
仭	仞
𠇞	伎
𪜬	余
𪜱	余
𪜩	佝
侣	侶
俣	俁
併	倂
𫝉	倉
𠉀	候
𠋣	倚
偼	倢
值	値
俱	倶
偷	偸
𠋏	傊
𩑭	傾
偽	僞
兊	兌
兑	兌
兎	兔
兖	兗
俞	兪
𠔃	兮
𠔏	共
册	冊
𠳲	冔
净	凈
凢	凡
凣	凡
𠙽	凷
刄	刃
𠛬	刑
别	別
删	刪
刹	剎
剏	剙
剥	剝
劔	劒
𠠤	劖
𠠥	劖
㓛	功
𠡍	劲
勊	勀
𠡳	勔
𠢀	勤
𠢄	勤
匀	勻
匄	匃
𭅅	匈
𠥆	匩
㔺	卋
𠦔	卋
𤰞	卑
𠦢	協
𠀄	卫
巻	卷
巹	卺
即	卽
𤓾	受
𠮉	叡
呑	吞
𭇅	吱
吴	吳
呉	吳
𠯵	吳
呐	吶
告	吿
吕	呂
㕼	哅
𫪾	唴
𠸝	啑
啓	啟
𫪓	喕
𠺇	喜
唧	喞
喻	喩
𠦤	單
𠫹	單
𠹫	嗇
𫪻	嗤
𭒕	嘙
嘷	噑
嘘	噓
𠾖	器
嚔	嚏
𡃰	嚱
𫝝	嚴
𡅛	嚵
𡅕	囍
冏	囧
𡆾	囧
𭍛	囧
圏	圈
圎	圓
圗	圖
圡	土
𡈽	土
𡊹	垔
𡍑	埊
埓	埒
𦰌	堇
𡍷	堩
𫝔	堯
𭏕	塌
填	塡
𡎖	塤
塈	墍
増	增
𫮰	墻
𡉟	壯
夀	壽
夛	多
𡖈	多
𢑑	多
𦴋	夢
𢎯	夷
𫯠	奉
奂	奐
𭁗	奠
奥	奧
𡚱	妃
𡛇	妓
𪥩	妓
姗	姍
妍	姸
娯	娛
娱	娛
𡝘	娽
𡝤	婁
媫	婕
媮	婾
𡞎	媔
𫱇	媜
𡠌	媲
媪	媼
媯	嬀
嬷	嬤
𡣳	孅
𡤼	孑
孳	孶
宫	宮
𡨘	寃
𡨚	寃
寜	寧
寛	寬
専	專
専	專
𫴰	對
尓	尔
尚	尙
尫	尪
𡯓	尬
𠒖	尭
𡰁	尰
𡰅	尳
尶	尷
𫝲	尻
屏	屛
𭕙	屛
𡵨	岐
𡵲	岐
𡷊	岛
𫝍	岡
峥	崢
𡾟	巇
巔	巓
坙	巠
𢁉	巽
㠶	帆
帡	帲
𢂸	帶
𢃄	帶
并	幷
𭎎	幸
𪜊	广
𢇮	庋
𢇭	应
𢈏	庚
𢊁	廌
廄	廏
𢋨	廛
廽	廻
弑	弒
𢎞	弘
𢏏	弥
录	彔
彚	彙
𢑥	彙
彛	彜
彞	彝
彦	彥
徴	徵
徳	德
𢘚	忱
𫝹	念
恒	恆
𢘆	恆
悦	悅
悮	悞
惪	悳
恵	惠
恵	惠
𢚾	愌
𭐫	愛
𢝾	愮
慎	愼
𫺼	慆
愠	慍
𢠊	慘
𢣗	懡
𫻡	懷
懴	懺
戬	戩
戯	戱
户	戶
戸	戶
戻	戾
𢩾	执
𠄘	承
𢪩	投
抛	拋
抜	拔
捝	挩
揑	捏
㨗	捷
𪮓	捹
挣	掙
挿	插
揷	插
换	換
搄	揯
摇	搖
捜	搜
揾	搵
揺	摇
𢲄	摕
𢳛	摣
𢷇	摤
撃	擊
𢷬	擣
舉	擧
𦦙	擧
㩥	攕
𤽐	敀
𤽑	敀
教	敎
敚	敓
𢻎	散
𭣹	散
𢻗	敮
㪣	敲
𫾣	敲
夐	敻
𢿌	敻
敿	敽
𢻤	敽
𢻧	斀
𣀈	斀
螤	斔
𣂷	斳
𣂼	斳
㫌	旋
既	旣
峕	旹
峕	旹
𣅐	旻
昻	昂
𣆃	昜
𣆄	昜
𫞄	晉
𣇈	晓
晩	晚
曍	暭
暨	曁
𣉊	曉
曽	曾
朶	朵
𣏓	杇
𠄬	枣
𡗭	枣
柺	枴
栅	柵
查	査
柡	栐
𫞉	桺
鿄	梁
𭐧	梦
棁	梲
榆	楡
𬃜	楨
榅	榲
槙	槇
㮣	槩
概	槪
𪳝	槱
橰	槹
𣙁	樝
榝	樧
𣝢	樸
𣜀	樾
横	橫
㰇	櫼
𣟬	欄
櫸	欅
𣟱	欅
㰱	歃
歩	步
歳	歲
𫞓	歲
𠧔	歺
殁	歿
殱	殲
殻	殼
毁	毀
毎	每
𣮟	毵
𫞕	氏
𫞖	民
氲	氳
𣲅	江
𣲄	汣
没	沒
𣴑	流
𣵀	涅
渉	涉
涚	涗
涙	淚
渌	淥
浄	淨
清	淸
涣	渙
渇	渴
𣷍	湄
𭰫	湎
温	溫
滚	滾
𭑞	漁
溉	漑
𣻌	漾
潨	潀
溈	潙
濳	潛
澙	潟
𣽽	潸
𣿰	濬
𤀹	濬
濲	瀔
瀬	瀨
瀐	瀸
𢌇	灋
𤂦	灌
𫞞	灌
𪸓	炁
奌	点
熙	煕
𤋮	煕
焭	煢
𠙦	煢
焕	煥
煴	熅
𤋱	熏
𤒄	燫
𤐭	燽
𤑕	爋
𤑛	爋
争	爭
為	爲
𡙁	爽
𫝃	爾
𫵠	犀
𫞤	猿
奬	獎
獋	獔
𤡯	獡
𫉬	獲
𤣥	玄
𤣱	玘
𤥨	琢
𤨁	瑨
𭺛	瓦
𭺜	瓦
瓶	甁
𠥄	甚
𫞪	甚
産	產
𤰱	画
𤲃	畢
𭺾	畢
畵	畫
𤲯	畫
𤲿	畫
𤴁	疉
𤴡	疐
痪	瘓
𤸄	瘝
痩	瘦
臯	皐
皡	皥
𥁋	盇
𫞰	盈
𥁘	盏
𥁫	盏
𭕘	眉
真	眞
衆	眾
𥈤	睫
𥌒	瞽
𥑉	砈
𥒐	砉
𮀒	砉
研	硏
𥓓	碑
𥔵	磁
鿆	祓
𥚬	祹
禄	祿
𥜽	禼
𥜾	禼
秃	禿
䄵	秊
𥝝	秊
税	稅
𥡴	稽
穂	穗
𫞹	空
𥤮	突
筝	箏
𥭼	箓
𥮷	箬
𥲒	築
𥰉	篌
簒	篡
𥱡	篾
箳	簈
簔	簑
𥶉	籑
籖	籤
𥹣	粣
𥹤	粣
𥺁	粧
𥹭	粱
粤	粵
𫒀	粵
𬗋	紫
絶	絕
緑	綠
緒	緖
縁	緣
𬗟	緬
𬗨	緽
緼	縕
𬗫	縣
𦅩	繪
纎	纖
𦉳	网
芈	羋
羙	美
𫟈	美
𮎪	美
𦍛	羕
羮	羹
翺	翶
翺	翶
𫰗	耍
𦕓	聓
𠕎	肉
𮌇	肉
䏍	肙
𦙪	肩
𦙌	胤
𦙍	胤
䏻	能
𦝕	能
𮌛	能
𦛹	胾
脱	脫
𦜉	脾
胼	腁
腽	膃
𦟾	膒
𦤀	臭
𦤺	致
臾	臾
𠒍	臾
𢆍	臿
𦥝	舀
舃	舄
𠢎	舅
𫟋	與
𦦙	舉
𦾔	舊
舎	舍
舗	舖
𫇧	芩
𠰥	若
䒮	茕
兹	茲
𦯬	荼
𭄳	莇
𦮆	菆
葘	菑
𫟏	菟
𦵉	萐
𦳆	萒
𦳯	蒁
蒀	蒕
𦻴	蓵
蓘	蔉
蓘	蔉
𦷾	蔕
蒍	蔿
蕰	薀
𦿾	藜
藴	蘊
𧁨	蘓
𡖂	虁
𮓗	虍
𮓙	虎
虚	虛
𮓥	虞
𮓰	虫
𧈡	蚤
𫊫	蚤
𧊨	蚦
蜖	蛔
𧉨	蛩
蜕	蛻
𧎉	蜣
𧑛	蟰
𫟘	衞
𮕩	衰
𡊮	袁
𡋡	袁
䘠	袚
衮	袞
𬡄	袞
𧞬	襳
𫟜	觀
𣫅	觳
𧦖	訰
訮	詽
𧦷	詾
説	說
𧪌	誱
𧫴	謹
𧭖	議
𫟝	讓
䜟	讖
𧰼	象
豜	豣
𭾛	貞
𢎐	貳
賘	賍
𦢼	贏
赱	走
𧺆	走
𧻬	趍
𨂹	踴
𨃒	踴
輺	輜
軿	輧
輼	轀
𫝕	辰
迖	达
逥	迴
迸	逬
𨓻	逯
𨓜	逸
逹	達
邢	郉
郎	郞
𮟿	郿
郷	鄕
鄉	鄕
𨞤	鄶
𨢄	醜
醖	醞
釼	釰
鈃	銒
鋭	銳
𨦵	鋩
録	錄
𨭀	鎘
鎮	鎭
𨮺	鑙
𨯒	鑯
𨳇	門
閲	閱
䦨	闌
𨺓	隆
陧	隉
𨻶	隙
寉	隺
𨿽	雖
𮥿	雚
青	靑
静	靜
靣	面
靱	靭
𮧰	韋
𩑠	頙
𮚱	頳
𥛤	頴
頽	頹
顔	顏
顛	顚
𩔖	類
𩚆	飤
飲	飮
餅	餠
馱	駄
駢	騈
𩥕	騹
𩥾	驗
骩	骫
髪	髮
鬬	鬭
𩵋	魚
𩹌	鰥
鰛	鰮
𡰎	鳩
𩾛	鳩
𩾵	鳩
𠒎	鳬
鳯	鳳
𪃰	鶰
鷏	鷆
𪃟	鷇
麫	麪
𬹃	麵
麽	麼
黄	黃
𮮐	黍
𮮑	黍
𪏭	黎
黒	黑
皷	鼓
𭽸	鼕
𮮫	鼞
𣦗	齒
𮮽	齒
榉	﨔
𧺯	﨣
𤔁	𠀭
𤕤	𠁊
𭑘	𠁊
𤕣	𠃾
𢆣	𠆕
𫝇	𠇭
𠈖	𠈪
𠈫	𠈪
𠊯	𠋢
𠋕	𠌖
𠏴	𠐑
𠓵	𠓷
𠕂	𠕅
𭁡	𠕅
𡴊	𠕓
𣍓	𠕰
𤎹	𠘕
𦥒	𠚒
𢩬	𠛃
𠜰	𠜧
𡘢	𠜵
𭃤	𠝄
𠜕	𠝞
𠝠	𠝬
𠢅	𠢍
𠥇	𠥵
𠦕	𠦘
𠧳	𠧹
𫝂	𠩄
𫠦	𠩄
𠩶	𠩲
𠪬	𠪚
𠰒	𠰚
𭉈	𠺜
𭊋	𠺜
𡀼	𡀘
𠿎	𡁑
𡂤	𡂧
𭋲	𡄑
𡌸	𡌹
𣡆	𡕏
𢻯	𡕕
𢾶	𡕲
𡙛	𡙠
𡦲	𡦭
𡦳	𡦭
𡦴	𡦭
𡪋	𡪚
𡮼	𡮻
𠠵	𡯄
𡯪	𡯭
𡰞	𡰝
𠔅	𡰤
𠔆	𡰤
𡥸	𡲪
𡵄	𡴀
𡴙	𡴐
𡸱	𡴜
𡴡	𡴩
𡴻	𡴲
𡻵	𡻫
𡼬	𡼒
𤎚	𡼷
𤿄	𢀎
𢆩	𢆢
𢉇	𢈩
𦱤	𢍋
𢎱	𢎨
𢎮	𢎶
𢑙	𢑛
𦄳	𢑲
𢀚	𢒄
𢒅	𢒄
𢔺	𢔷
𢡤	𢡍
𢦒	𢦔
𢪨	𢪚
𫽅	𢬱
𪭻	𢭀
𪭱	𢭯
𢮸	𢰷
𢱞	𢱞
𢱭	𢳎
𢷐	𢷟
𢾪	𢻚
𢼯	𢼴
𣁋	𢼸
𢾛	𢾊
𭣙	𢾊
𢻕	𢾑
𢾚	𢾑
𢿽	𢿦
𭣝	𢿦
𢿵	𢿧
𭣜	𢿧
𢻥	𢿾
𣀉	𢿾
𣀸	𣀺
𧥙	𣁀
𣊆	𣊅
𣊭	𣊫
𦙿	𣍦
𦙳	𣍨
𦜷	𣎄
𫠡	𣎴
𣐂	𣏋
𣑾	𣑅
𭪉	𣒀
𣕹	𣓉
𣒆	𣓘
𣒏	𣓙
𤴜	𣓜
𣕏	𣓧
𠓲	𣔕
𫞎	𣘺
𫞏	𣘺
𣝿	𣞱
𣝡	𣞼
𣦋	𣥫
𣥩	𣥿
𣨃	𣧴
𣫃	𣫌
𣚯	𣫎
𣮯	𣮸
𣮗	𣮻
𣳊	𣳃
𣳫	𣵭
𣶬	𣷉
𣷹	𣸸
𣾞	𣽁
𭒞	𣽦
𣽍	𣾄
𤂴	𤃪
𤅃	𤅄
𤊮	𤉺
𤐥	𤑋
𤓿	𤔂
𠚞	𤔼
𡖀	𤔿
𤖊	𤖄
𭆌	𤟐
𤟌	𤟒
𤣔	𤣗
𤣭	𤣲
𤤄	𤣻
𤧩	𤦼
𡨍	𤬽
𤮬	𤮫
𪐕	𤯒
𢍚	𤱿
𤵵	𤵨
𬏝	𤵶
𤿪	𥀈
𬐱	𥂭
𥄚	𥄙
𥆆	𥆨
𥇗	𥇵
𥇤	𥇵
𥈃	𥈟
𥈺	𥉰
𥑪	𥒚
𥔉	𥔑
𥑷	𥔢
𥒏	𥔢
𬒛	𥕧
𥛈	𥙸
𮂁	𥚣
𥡱	𥡤
𥦐	𥦪
𥪺	𥫃
𥫕	𥫖
𥬘	𥬟
𥰓	𥯣
𥰅	𥲂
𥲤	𥳁
𥳸	𥳹
𥵄	𥶅
𥷴	𥷤
𦀉	𥿰
𦁇	𦁤
𦂲	𦁥
𦅳	𦃍
𬼉	𦈢
𦎜	𦎇
𢐽	𦏚
𦏴	𦏻
𦘚	𦘕
𦙽	𦙱
𦊈	𦚋
𬚹	𦚩
𣍭	𦚹
𦚸	𦚹
𦛧	𦜡
𦜤	𦝦
𦡦	𦡂
𦢋	𦣍
𦣞	𦣝
𥃢	𦣸
𦤺	𦤶
𢲓	𦥹
𠮌	𦦖
𦨳	𦨼
𦪲	𦪓
𦪺	𦪲
𦭠	𦭫
𦲝	𦰓
𦴃	𦵫
𦸥	𦼏
𦺺	𦽓
𦾽	𦿚
𧃱	𧂘
𦾫	𧂣
𧆬	𧆟
𧆭	𧆣
𧇄	𧇄
𧇕	𧇄
𧊱	𧊶
𧊠	𧍳
𧎅	𧏚
𧟡	𧟠
𧟵	𧟱
𧧂	𧦽
𧧇	𧧨
𧨤	𧨚
𧩱	𧫮
𦌽	𧮀
𧯖	𧯕
𧶀	𧶊
𧹩	𧹯
𧿪	𧿝
𨇈	𨆫
𨍽	𨎊
𨏓	𨏪
𨑃	𨑄
𢀽	𨑔
𨖀	𨔢
𨖼	𨖙
𨗭	𨖽
𨗌	𨗤
𨛻	𨛲
𨜭	𨜓
𨡦	𨢂
𨢫	𨣊
𨥀	𨥄
𨰦	𨰰
𨵻	𨶒
𨷭	𨷠
𨹃	𨹄
𩃢	𩃔
𩅧	𩅉
𩆹	𩇂
𩉩	𩉨
𩉲	𩉨
𢻨	𩐅
𩑄	𩑃
𩑑	𩑗
𩑿	𩒕
𩒋	𩒕
𩖜	𩖛
𩞟	𩝫
𩟣	𩟤
𩢯	𩣇
𩣈	𩣐
𩣦	𩣮
𩦔	𩦴
𩫗	𩫖
𮫄	𩬻
𩯶	𩰁
𩱽	𩲄
𩵉	𩵊
𩹦	𩸑
𩿗	𩿎
𪀙	𪃪
𪇞	𪇀
𪈈	𪈐
𫜎	𪊨
𪏃	𪏂
𡒢	𪔋
𡒡	𪔌
𥖫	𪔑
𥀻	𪔯
𥀼	𪔴
𬹵	𪘉
𤒅	𪚱
𨉠	𪧻
𢺻	𪯈
𢻳	𪯈
𦾀	𫉌
𮙅	𫍔
𰼯	𫒡
𭪢	𬃄
𣟃	𬄺
𨗵	𬇓
𬍭	𬍵
𤫞	𬎞
𤱏	𬏂
𫈯	𬝆
𬻔	𬻐
𭁇	𭁈
𰈥	𭊕
𡾠	𭗲
𮐛	𮏨
𩼻	𮓖
𮔃	𮓻
𧪤	𮘭
𩟚	𮩑
𦤓	𮮴
𰜛	𰜚
𥚳	𰨋
𬻋	𱽌
𦰥	𱽨
